9xxxxxxxxx
z112111121
z121112111
z111111111
z112111111
z111111111
z211112111
z111111121
z112111111
z111111211